1111111111111111111111111
10P0100001100000100000C01
1100100101101010001100111
11100001C0000010101110001
1C00100101001010000000001
1111111111111C11111111111
1000000000000010000000001
111C111000010010000000001
1000000011110000000110101
1111110111000111110110101
1111110110010001110110101
111C000000111100000000CE1
1111111111111111111111111