1111111111111
10010000000C1
1000011010111
1P0000EC00001
1111111111111