1111111111111
10010000000C1
1P00011111001
10M011E000001
1111111111111