1111111111111
100100M0000C1
1000011010111
1P0000EC000M1
1111111111111